25 20
   ###################
 ##...................##
#...s...s...##..........#
#...........##..........#
#................##.....#
#.....s..##......##.....#
#........##.............#
##.....................##
  ####.#############..#
     #.#           #..#
     #.#           #..#
     #D#          ##..##
  ####.####      #......#
  #.......#      #......#
  #.......#      #......#
  #.......#      #......#
  #...@...#      #......#
  #...^...#      #......#
  #.......#      #...v..#
  #########       ######
