25 20
#############
#...........#    ########
#...s...s...######......#
#..............D........#
#...........######......#
#.....s.....#    #......#
#...........#    #......#
#...........#    #......#
#####..######    ###..###
    #..#           #..#
    #..#           #..#
    #DD#          ##..##
  ###..####      #......#
  #.......#      #......#
  #.......#      #......#
  #.......#      #......#
  #...@...#      #......#
  #...^...#      #......#
  #.......#      #..v...#
  #########       ######
